You wake up. It's not comfortable. Oh wow, what a night! Did you drink too much again? Oh no, right. You're in your smoothie healthy lifestyle phase right now. But you do remember last night being rough. You do remember your step sister Kylie acting weird. You remember the sky turning dark and a storm destroying your house and masses of strangers with torn clothes chasing your entire family. Or maybe it was all just a nightmare? I bet it was. You'll have to tell Kanye and Kendall and Khloé and everyone about this dream. And the entire snapchat community. But where's your husband and your kids? And more importantly, where's your phone?

Keeping Up With The Apocalypse
An Interactive Fiction by Inés Peyser-Kreis
Release 1 / Serial number 160730 / Inform 7 build 6M62 (I6/v6.33 lib 6/12N) SD

Stairs
You are on the stairs in front of a formerly fancy house, looking rather destroyed. Your house? You don't know at the moment. You seem to have hit your head and don't remember everything. There are two impressive, but graffiti sprayed columns next to you. In the wall is an electrical outlet with a charging cable attached to it.

To the west is a little corner around the wall. To the north is the mansion. To the south is a big courtyard.

>go south
Courtyard
The courtyard is seamed with withered bushes. You see a fountain. Looking southeast, you can leave your property. Looking north are the stairs that lead you to your mansion.

* * *

>x columns
Someone sprayed graffiti over your beautiful baroque columns: "Everybody knows I'm a motherfucking monster." Oh no, is Kanye having one of these days again?

>x bushes
You can't see any such thing.

>go south
Courtyard
The courtyard is seamed with withered bushes. You see a fountain. Looking southeast, you can leave your property. Looking north are the stairs that lead you to your mansion.

>x fountain
You can't see any such thing.

>go southeast
Driveway
You are in your driveway. To the sides of the driveway are bushes.  Looking northwest is the courtyard.

You can see Bushes here.

>x bushes
These are xy kind of bushes. You touch them and realize that there, in the north is a car parked right behind them.

>go north
Car

>go south
Driveway
You are in your driveway. To the sides of the driveway are bushes.  Looking northwest is the courtyard.

You can see Bushes here.

>go northwest
Courtyard
The courtyard is seamed with withered bushes. You see a fountain. Looking southeast, you can leave your property. Looking north are the stairs that lead you to your mansion.

>x bushes
You can't see any such thing.

>go north
Stairs In Front Of The Mansion
You wake up. It's not comfortable. You look around and realize that you're lying on the stairs in front of a big house, looking rather destroyed, north of you. Your house? You don't know at the moment.

To the south is a big courtyard. There are two impressive, but graffiti sprayed columns next to you and what used to be bushes.

* * *

>x columns
Someone sprayed graffiti over your beautiful baroque columns: "Everybody knows I'm a motherfucking monster." Oh no, is Kanye having one of these days again?

>x flowers
Maybe one day these were beautiful blooming flowers, but now these's not much left of them. You see something shimmering between the flowers. A key?

In flowers is a Silver Key.

>x key
A medium sized silver key with a big ugly engraving of a dollar sign. Seriously?

>take silver key
Taken.

>i
You are carrying:
  The Silver Key

>x
(The Silver Key)
You see nothing special about The Silver Key.

>look
Stairs
You wake up. It's not comfortable. You look around and realize that you're lying on the stairs in front of a big house, looking rather destroyed, north of you. Your house? You don't know at the moment.

To the south is a big courtyard. There are two impressive, but graffiti sprayed columns next to you and what used to be flowers.

You can see Columns and Flowers here.

>go south
Courtyard
The courtyard is seamed with withered bushes. You see a fountain. Looking southeast, you can leave your property. Looking north are the stairs that lead you to your mansion.

>go southeast
Driveway
You are in your driveway. To the sides of the driveway are bushes.  Looking northwest is the courtyard.

You can see a Car Door and Bushes here.

>x bushes
These are xy kind of bushes. You touch them and realize that there, in the north is a car parked right behind them.

>go north
(first opening the Car Door)
It seems to be locked.

>unlock door
(with The Silver Key)
You unlock the Car Door.

>go north
(first opening the Car Door)

Car
You can see a Car Door here.

* * *

>x columns
Someone sprayed graffiti over your beautiful baroque columns: "Everybody knows I'm a motherfucking monster." Oh no, is Kanye having one of these days again?

>x column
You can't see any such thing.

* * *

>go north
(first opening the giant door)
It seems to be locked.

>go south
Courtyard
The courtyard is seamed with cherry trees. You see a fountain. Looking southeast, you can leave your property. Looking north are the stairs that lead you to your mansion.

You can see Zombie Kylie Jenner here.

Though Kylie isn't moving very fast, she definitely is moving towards you. Do you want to end up as a braineater, too?

>go southeast
Driveway
You are in your driveway. To the sides of the driveway are bushes.  Looking northwest is the courtyard.

You can see a Car Door and Bushes here.

* * *

>go north
(first opening the Car Door)
It seems to be locked.

>unlock car door
What do you want to unlock the Car Door with?

>i
You are carrying nothing.

* * *

>go south
Courtyard
The courtyard is seamed with cherry trees. You see a fountain. Looking southeast, you can leave your property. Looking north are the stairs that lead you to your mansion.

You can see Zombie Kylie Jenner here.

Though Kylie isn't moving very fast, she definitely is moving towards you. Do you want to end up as a braineater, too?

>help
That's not a verb I recognise.

>n
Stairs
You look around and realize that you're lying on the stairs in front of a big fancy house, looking rather destroyed, north of you. Your house? You don't know at the moment. You seem to have hit your head and don't remember everything.

To the south is a big courtyard. There are two impressive, but graffiti sprayed columns next to you and what used to be flowers.

>x columns
Someone sprayed graffiti over your beautiful baroque columns: "Everybody knows I'm a motherfucking monster." Oh no, is Kanye having one of these days again?

* * *

>go south
Courtyard
The courtyard is seamed with cherry trees. You see a fountain. Looking southeast, you can leave your property. Looking north are the stairs that lead you to your mansion.

You can see Zombie Kylie Jenner here.

Though Kylie isn't moving very fast, she definitely is moving towards you. Do you want to end up as a braineater, too?

>x Kylie
Your once beautiful step sister Kylie, one of those basic bitches who use snapchat way too much - oops - and drink one extra ice cold ice tea macha latte with double whipped cream and a shot of hazelnut aroma per hour has turned into a monster. She seems to be wearing a pink key around her neck.

Kylie is not the sister she used to be. You probably can't trust her. You'll want to get out of here.

* * *

>go north
(first opening the giant door)
It seems to be locked.

>x chunk of wood
A big chunk of wood is blocking the door into the house. God damnit!

>take chunk of wood
It's not that it looks too heavy for you to pick it up, but it has blood splashed all over it. Do you really want to get your hands dirty?

>x flowers
Maybe one day these were beautiful blooming flowers, but now these's not much left of them. You see something shimmering between the flowers. A key?

>x key
You see nothing special about the Silver Key.

* * *

>x flowers
Maybe one day these were beautiful blooming flowers, but now these's not much left of them. You see something shimmering between the flowers. A key?

In flowers is a Silver Key.

* * *

>x key
A medium sized silver key with a big ugly engraving of a dollar sign. Seriously?

>take key
Taken.

>go south
Courtyard
The courtyard is seamed with cherry trees. You see a fountain. Looking southeast, you can leave your property. Looking north are the stairs that lead you to your mansion.

You can see cherry trees and a fountain here.

>x cherry trees
These cherry trees used to bloom. Now one of them is chopped down, another one if covered in something that looks like... brains? You better look away if you wanna keep your breakfast.

>go southeast
Driveway
You are in your driveway. To the sides of the driveway are bushes.  Looking northwest is the courtyard.

You can see a Car Door and Bushes here.

>x bushes
These are withered rhododendrons. You touch them and realize that there, in the north is a car parked right behind them. It's a big black jeep that frequently parks in your family driveway. Who does it belong to again?.

>go north
(first opening the Car Door)
It seems to be locked.

>unlock car
(with the Silver Key)
You unlock the Car Door.

>go north
(first opening the Car Door)

Car
You get in the black jeep, sitting in the passenger seat. This car has definitely seen better times. There's a big sheet of paper spread over the dashboard. You look to your right and see a bulky thing covered in cloth and blood on the driver seat. You spot a gold chain... a pair of black sneakers... pretentious tattoos... Oh no, this is Tyga! Your sister Kylie's "rapper" boyfriend. He doesn't seem to be very alive anymore. Good bye rapping career.

You can see a Car Door, a Dead Tyga and a Paper here.

>x tyga
Tyga's brain is splattered all over his former shiny black sneakers. What a shame! For the sneakers, I mean. Tyga himself was always pretty annoying, thinking he could compete with Kanye. Ridiculous! Well, whatevs. He's gone now. What might he have been doing here? Now I remember, this is his car. Was he about to drive somewhere before some zombie ate his brains?

>x paper
The large sheet of paper is a map of the United States Of America! There are some lines drawn in. They lead from here, Beverly Hills, to... the middle of nowhere in North Dakota. There's a big circle around the all capital letters "THE GREEN PLACE". Is this supposed to be some kind of joke?

Your smartphone beeps.

* * *

>take key
Taken.

>n
(first opening the giant door)
The giant door leading in the mansion is blocked by a big chunk of wood.

>x wood
A big chunk of wood is blocking the door into the house. God damnit!

>take wood
It's not that it looks too heavy for you to pick it up, but it has blood splashed all over it. Do you really want to get your hands dirty?

>take chunk
It's not that it looks too heavy for you to pick it up, but it has blood splashed all over it. Do you really want to get your hands dirty?

>s
Courtyard
The courtyard is seamed with cherry trees. You see a fountain. Looking southeast, you can leave your property. Looking north are the stairs that lead you to your mansion.

>se
Driveway
You are in your driveway. To the sides of the driveway are bushes.  Looking northwest is the courtyard.

>x bushes
These are withered rhododendrons. You touch them and realize that there, in the north is a car parked right behind them. It's a big black jeep that frequently parks in your family driveway. Who does it belong to again?.

>n
(first opening the Car Door)
It seems to be locked.

>unlock car door with silver key
You unlock the Car Door.

>n
(first opening the Car Door)

Car
You get in the black jeep, sitting in the passenger seat. This car has definitely seen better times. There's a big sheet of paper spread over the dashboard. You look to your right and see a bulky thing covered in cloth and blood on the driver seat. You spot a gold chain... a pair of black sneakers... pretentious tattoos... Oh no, this is Tyga! Your sister Kylie's "rapper" boyfriend. He doesn't seem to be very alive anymore. Good bye rapping career.

You can see a dashboard (on which is a Map) and Driver Seat (on which is Dead Tyga) here.

* * *

>x flowers
Maybe one day these were beautiful blooming flowers, but now these's not much left of them. You see something shimmering between the flowers. A key?

In flowers is a Silver Key.

>take key
Taken.

* * *

>go south
Courtyard
The courtyard is seamed with cherry trees. You see a fountain. Looking southeast, you can leave your property. Looking north are the stairs that lead you to your mansion.

You can see cherry trees and a fountain here.

>go southeast
Driveway
You are in your driveway. To the sides of the driveway are bushes.  Looking northwest is the courtyard.

You can see a Car Door and Bushes here.

>unlock car
(with the Silver Key)
You unlock the Car Door.

* * *

>x tyga
Tyga's brain is splattered all over his former shiny black sneakers. What a shame! For the sneakers, I mean. Tyga himself was always pretty annoying, thinking he could compete with Kanye. Ridiculous! Well, whatevs. He's gone now. What might he have been doing here? Now I remember, this is his car. Was he about to drive somewhere before some zombie ate his brains?

>x paper
The large sheet of paper is a map of the United States Of America! There are some lines drawn in. They lead from here, Beverly Hills, to... the middle of nowhere in North Dakota. There's a big circle around the all capital letters "THE GREEN PLACE". Is this supposed to be some kind of joke?

Your smartphone beeps.

It's a messafe from Tyga. Say what? I reads:

"Yo Kim, you fine ass looking girl! I just wanted to tell you that I've always been madly in love with you. Yo" ass is just so much more damn fine than Kylie's. But oh well, if you're reading this, it's too late. I programmed my phone to send you this message in case I don't use it for 2 hours, which would mean I'm dead.

I already realized a few weeks ago that weird things happen to Kylie when she uses the zombie filter on snapchat. She would start to move all weird and start biting my head and moaning "Braaaains". I already figured she would turn into a zombie, which would then lead to the Zombie Apocalypse, which we are in right now. The zombies eat social-media-infected brains. Which means: They won't go where people live who don't use social media. I found a place on the earth where this is true: North Dakota. The internet reception is just too weak. That's why the zombies will never go there. The GREEN PLACE. It's the only chance left!

I was going to flee there with you, my girl. But oh well, now it's too late for me. But you still have a chance. Get your family together and drive to the Green Place. Have a nice life there. Bitch.

* * *

>look at graffiti
You can't see any such thing.

>look at flowers
Maybe one day these were beautiful blooming flowers, but now these's not much left of them. You see something shimmering between the flowers. A key?

>take key
Taken.

>look at key
A medium sized silver key with a big ugly engraving of a dollar sign. Seriously?

>look at columns
Someone sprayed graffiti over your beautiful baroque columns: "Everybody knows I'm a motherfucking monster." Oh no, is Kanye having one of these days again?

>who is kanye
That's not a verb I recognise.

>s
Courtyard
The courtyard is seamed with cherry trees. You see a fountain. Looking southeast, you can leave your property. Looking north are the stairs that lead you to your mansion.

You can see cherry trees and a fountain here.

>take all
cherry trees: Taken.
fountain: Taken.

>chop tree
You can't see any such thing.

>go north
Stairs
You wake up. It's not comfortable. You look around and realize that you're lying on the stairs in front of a big house, looking rather destroyed, north of you. Your house? You don't know at the moment.

To the south is a big courtyard. There are two impressive, but graffiti sprayed columns next to you and what used to be flowers.

You can see a giant door, columns, flowers and a chunk of wood here.

>u
You can't go that way.

* * *

>take key
Taken.

>s
Courtyard
The courtyard is seamed with cherry trees. You see a fountain.
Going southeast, you can leave your property. To the north are the stairs that lead you to your mansion.

You can see Zombie Kylie Jenner here.

Kylie is not the sister she used to be. You probably can't trust her. You'll want to get out of here.

>se
Driveway
You are in your driveway. To the sides of the driveway are bushes.  Looking northwest is the courtyard.

There are so many beautiful or gross things around you. All worth capturing. Your snapchat followers miss you already. And who knows, connecting might help you out of this mess as well...

>n
(first opening Bushes)

Backyard
This is your backyard.
To the south through the bushes you get back to the driveway.

You can see the car (closed) here.

>open car door
It seems to be locked.

>unlock car door
(with the Silver Key)
You unlock the Car Door.

>n
(first opening the Car Door)

Car
You get in the black jeep, sitting in the passenger seat. This car has definitely seen better times. There's a big sheet of paper spread over the dashboard. You look to your right and see a bulky thing covered in cloth and blood on the driver seat. You spot a gold chain... a pair of black sneakers... pretentious tattoos... Oh no, this is Tyga! Your sister Kylie's "rapper" boyfriend. He doesn't seem to be very alive anymore. Good bye rapping career.

You can see a Car Door, a Dead Tyga and a Paper here.

>x paper
The large sheet of paper is a map of the United States Of America! There are some lines drawn in. They lead from here, Beverly Hills, to... the middle of nowhere in North Dakota. There's a big circle around the all capital letters "THE GREEN PLACE". Is this supposed to be some kind of joke?

Your smartphone beeps.

It's a message from Tyga. Say what? I reads:

"Yo Kim, you fine ass looking girl! I just wanted to tell you that I've always been madly in love with you. Yo ass is just so much more damn fine than Kylie's. But oh well, if you're reading this, it's too late. I programmed my phone to send you this message in case I don't use it for 2 hours, which would mean I'm dead.

I already realized a few weeks ago that weird things happen to Kylie when she uses the zombie filter on snapchat. She would start to move all weird and start biting my head and moaning "Braaaains". I already figured she would turn into a zombie, which would then lead to the Zombie Apocalypse, which we are in right now. The zombies eat social-media-infected brains. Which means: They won't go where people live who don't use social media. I found a place on the earth where this is true: North Dakota. The internet reception is just too weak. That's why the zombies will never go there. The GREEN PLACE. It's the only chance left!

I was going to flee there with you, my girl. But oh well, now it's too late for me. But you still have a chance. Get your family together and drive to the Green Place. Have a nice life there. Bitch."

>h
That's not a verb I recognise.

>a
That's not a verb I recognise.

>a
That's not a verb I recognise.

>x
(the Silver Key)
A medium sized silver key with a big ugly engraving of a dollar sign. Seriously?

>c
That's not a verb I recognise.

>v
That's not a verb I recognise.

I beg your pardon?

>d
You can't go that way.

I beg your pardon?

>f
That's not a verb I recognise.

>e
You can't go that way.

>e
You can't go that way.

>ef
That's not a verb I recognise.

>ef
That's not a verb I recognise.

>fe
That's not a verb I recognise.

>wfweffefefefefe
That's not a verb I recognise.

>fe
That's not a verb I recognise.

>f
That's not a verb I recognise.

I beg your pardon?

I beg your pardon?

* * *

>f
That's not a verb I recognise.

>f
That's not a verb I recognise.

* * *

I beg your pardon?

>ff
That's not a verb I recognise.

>f
That's not a verb I recognise.

* * *

I beg your pardon?

>s
Driveway
You are in your driveway. To the sides of the driveway are bushes.  Looking northwest is the courtyard.

You can see a Car Door and Bushes here.

I beg your pardon?

>s
You can't go that way.

I beg your pardon?

* * *

>s
You can't go that way.

>a
That's not a verb I recognise.

>aqww
That's not a verb I recognise.

>wer
That's not a verb I recognise.

>r
That's not a verb I recognise.

I beg your pardon?

>dd
That's not a verb I recognise.

>d
You can't go that way.

>d
You can't go that way.

* * *

>n
(first opening Bushes)

Backyard
This is your backyard.
To the south through the bushes you get back to the driveway.

You can see the car (closed) here.

>unlock car door with silver key
I didn't understand that sentence.

>unlock cardoor with silver key
You can't see any such thing.

>unlock car with silver key
You unlock the car.

>go in car
You can't get into the closed car.

>open car door
I only understood you as far as wanting to open the car.

>open car
You open the car, revealing nothing.

>go in car
You get in the black jeep, sitting in the passenger seat. This car has definitely seen better times. There's a big sheet of paper spread over the dashboard. You look to your right and see a bulky thing covered in cloth and blood on the driver seat. You spot a gold chain... a pair of black sneakers... pretentious tattoos... Oh no, this is Tyga! Your sister Kylie's "rapper" boyfriend. He doesn't seem to be very alive anymore. Good bye rapping career.

To the south, behind some bushes, is the driveway.

>x tyga
Tyga's brain is splattered all over his former shiny black sneakers. What a shame! For the sneakers, I mean. Tyga himself was always pretty annoying, thinking he could compete with Kanye. Ridiculous! Well, whatevs. He's gone now. What might he have been doing here? Now you remember, this is his car. Was he about to drive somewhere before some zombie ate his brains?

>x gold chain
You see nothing special about the gold chain.

>x shiny black sneakers
You see nothing special about shiny black sneakers.

>take sneakers
That seems to belong to dead Tyga.

There are so many beautiful or gross things around you. All worth capturing. Your snapchat followers miss you already. And who knows, connecting might help you out of this mess as well...

>talk to tyga
That's not a verb I recognise.

>talk to tyga about apocalypse
That's not a verb I recognise.

* * *

>n
(first opening Bushes)

Backyard
This is your backyard.
To the south through the bushes you get back to the driveway.

You can see the car (closed) here.

>s
Driveway
You are in your driveway. To the sides of the driveway are bushes.  Looking northwest is the courtyard.

>n
Backyard
You can see the car (closed) here.

* * *

>i
You are carrying:
  a smartphone
  D&G Stilettos (being worn)
  a blouse (being worn)

>w
Corner
You stand at a corner next to the stairs in front of your mansion. In front of you are flowers that have withered. 
To the east, you get to the stairs.

>take key
Taken.

>i
You are carrying:
  a silver key
  a smartphone
  D&G Stilettos (being worn)
  a blouse (being worn)

>e
Stairs
You are on the stairs in front of a formerly fancy house, looking rather destroyed. Your house? You don't know at the moment. You seem to have hit your head and don't remember everything. There are two impressive, but graffiti sprayed columns next to you. In the wall is an electrical outlet with a charging cable attached to it.

To the west is a little corner around the wall. To the north is the mansion. To the south is a big courtyard.

>s
Courtyard
Going southeast, you can leave your property. To the north are the stairs that lead you to your mansion.
The courtyard is seamed with cherry trees. You see a fountain.

You can see Zombie Kylie Jenner here.

>se
Driveway
You are in your driveway. To the sides of the driveway are bushes.  Looking northwest is the courtyard.

>n
(first opening Bushes)

Backyard
This is your backyard.
To the south through the bushes you get back to the driveway.

You can see the car (closed) here.

>unlock car with silver ke
I only understood you as far as wanting to unlock the car with the silver key.

>unlock car with silver key
You unlock and open the car.

>go in
You can't go that way.