You are starving. Maby there is something to eat in the jungle. The entrens is in the north. But be careful. Its like a labyrinth! Maby you should make a map on your own, otherwise you proberply get lost.

Gaisetto
An Interactive Fiction by Tobi The Start of the Adventure begins when play begins
Release 1 / Serial number 170617 / Inform 7 build 6M62 (I6/v6.33 lib 6/12N) SD

Landingzone
You can see After examining the smoketuber now Formizer here.

>l
Landingzone

* * *

>s
You can't leave the jungle yet. There is something to find out here!

>n
Jungle north of the spaceship

>e
Jungle north east of the spaceship

>s
Jungle north east of the Spaceship

>s
Jungle east of the Spaceship

>s
Jungle south east of the Spaceship

>s
You shouldn't remove yourself too far from the Spaceship, otherwise you'll get lost in the thicket of the jungle.

>w
Jungle south of the Spaceship

>w
Jungle south west of the Spaceship
You can see a Smoketuber here.

>take
(the Smoketuber)
Taken.

>e
Jungle south of the Spaceship

>e
Jungle south east of the Spaceship

>nn
That's not a verb I recognise.

>n
Jungle east of the Spaceship

>n
Jungle north east of the Spaceship

>n
Jungle north east of the spaceship

>w
Jungle north of the spaceship

* * *

>s
What the fuck! What are these? Are they animals? Oh no they hae weapons! They see you and start to souround you. What are you going to do?

>s
You can't go that way.

>a
That's not a verb I recognise.

>d
You can't go that way.

>e
You can't go that way.

>examine
(the Smoketuber)
You see nothing special about the Smoketuber.

>examine formizer
You see nothing special about now Formizer.

* * *

>n
Jungle north of the spaceship

* * *

>take
(the Smoketuber)
Taken.

>examine
(the Smoketuber)
You see nothing special about the Smoketuber.

>e
Jungle south of the Spaceship

* * *

>e
Jungle south east of the Spaceship

>n
Jungle east of the Spaceship

* * *

>s
What the fuck! What are these? Are they animals? Oh no they hae weapons! They see you and start to souround you. What are you going to do?

>look
Landingzone
You can see After examining the smoketuber now Formizer here.

>examine
(the Smoketuber)
You see nothing special about the Smoketuber.

>examine formizer
You see nothing special about After examining the smoketuber now Formizer.

* * *

You are starving. Maby there is something to eat in the jungle. The entrens is in the north. But be careful. Its like a labyrinth! Maby you should make a map on your own, otherwise you proberply get lost.

Gaisetto
An Interactive Fiction by Tobi The Start of the Adventure begins when play begins
Release 1 / Serial number 170617 / Inform 7 build 6M62 (I6/v6.33 lib 6/12N) SD

Landingzone
You can see After examining the smoketuber now Formizer here.

>examine
(After examining the smoketuber now Formizer)
You see nothing special about After examining the smoketuber now Formizer.

* * *

>s
You can't leave the jungle yet. There is something to find out here!

>s
You can't leave the jungle yet. There is something to find out here!

* * *

>s
Jungle south east of the Spaceship

>w
Jungle south of the Spaceship

* * *

>n
Jungle north east of the spaceship

>s
Jungle north east of the Spaceship

>n
Jungle north east of the spaceship