You got caught in a meteor shower and while trying your best to manouver your spaceship through it  your engine still took a hit. You then had to crash-land on Kaldríss - one of the most cold planets in this solar system.  Since only a few explorers made their to this planet there's not a whole lot of information available about this icy place. You are pretty much on your own now. The spaceship also won't take off before it hasn't been properly repaired. But first things first. Without any kind of heat you won't survive this bleakness for long.

Planet Kaldríss
An Interactive Fiction by Daniel
Release 1 / Serial number 170612 / Inform 7 build 6M62 (I6/v6.33 lib 6/12N) SD

Spaceship Bridge
The place where all the magic happens. Well, it used to be at least - during the impact most of the important equpiment including the communication systems must have been fried and doesn't seem to work anymore.  There's only a single illuminated button that is flickering on the command panel. What could this mean? Might be worth checking out.

>n
You can't go that way.

>s
You can't go that way.

>e
You can't go that way.

>w
You can't go that way.

* * *

>s
Spaceship Storage
Taking a quick look inside the storage room doesn't seem to reveal anything particularly interesting. There are only some random souvenirs from your previous intergalactic travels and your locker which you haven't opened in ages.

You can see a plasma cannon, a food ration, a Götti and a smoke nodule here.

>s
Spaceship Exit
Insert description here.

>s
You can't go that way.

* * *

>s
Spaceship Exit
Insert description here.

>e
You can't leave the spaceship just yet. You need to find something to keep you warm before you venture off!

>take all
You can't see any such thing.

>w
Nothing to see here.

>n
Spaceship Storage
Insert description here.

You can see a Plasma Cannon, a Food Ration, a Götti and a Smoke Nodule here.

>take all
Plasma Cannon: Even though this is a highly experimental weapon it might prove useful at some point.

Taken.
Food Ration: Taken.
Götti: Taken.
Smoke Nodule: Taken.

>e
Nothing to see here.

>s
Spaceship Exit
Insert description here.

* * *

>e
You can't leave the spaceship just yet. You need to find something to keep you warm before you venture off!

>s
Nothing to see here.

>n
Spaceship Storage
Insert description here.

>n
Spaceship Bridge
Insert description here.

You can see an Energy Orb here.

>n
Nothing to see here.

>n
Nothing to see here.

>take all
Energy Orb: Taken.

>s
Spaceship Storage
Insert description here.

I beg your pardon?

>s
Spaceship Exit
Insert description here.

>se
Nothing to see here.

>e
Crash Zone
Insert description here.

>go down
Yarwol's Cave
Insert description here.

Insert description here.

You can also see Yarwol's Keystone here.

>examine
What do you want to examine?

>s
You see nothing unexpected in that direction.

>e
Nothing to see here.

>s
Main Cave
Insert description here.

>w
Nothing to see here.

>e
This door doesn't seem to lead anywhere

>s
Nothing to see here.

>r
That's not a verb I recognise.

>e
This door doesn't seem to lead anywhere

>search person
You can't see any such thing.

>e
This door doesn't seem to lead anywhere

* * *

>s
Nothing to see here.

>n
Yarwol's Cave
Insert description here.

Insert description here.

You can also see Yarwol's Keystone here.

>w
Yundar's Cave
Insert description here.

Insert description here.

You can also see Yundar's Picking Tools here.

>w
Nothing to see here.

>search
What do you want to search?

>search person
You can't see any such thing.

* * *

>s
Spaceship Storage
Taking a quick look inside the storage room doesn't seem to reveal anything particularly interesting. There are only some random souvenirs from your previous intergalactic travels and your locker which you haven't opened in ages.

You can see a plasma cannon, a food ration, a Götti and a smoke nodule here.

>look around
You can't see any such thing.

>examine
What do you want to examine?

* * *

>s
Spaceship Storage
Taking a quick look inside the storage room doesn't seem to reveal anything particularly interesting. There are only some random souvenirs from your previous intergalactic travels and your locker which you haven't opened in ages.

You can see a plasma cannon, a food ration, a Götti and a smoke nodule here.

>x Locker
Do I really want to open up this thing? God knows what's inside.

On the Locker is a Fire Emergency Kit.

>take Fire Emergency Kit
Taken.

>s
Spaceship Exit
Insert description here.

>e
Crash Zone
Insert description here.

* * *

>s
Spaceship Storage
Taking a quick look inside the storage room doesn't seem to reveal anything particularly interesting. There are only some random souvenirs from your previous intergalactic travels and your locker which you haven't opened in ages.

You can see a plasma cannon, a food ration, a Götti and a smoke nodule here.

>x locker
You see nothing special about the Locker.

>x brushed metal box
You can't see any such thing.

>look around
You can't see any such thing.

* * *

>s
Spaceship Storage
Taking a quick look inside the storage room doesn't seem to reveal anything particularly interesting. There are only some random souvenirs from your previous intergalactic travels and your locker which you haven't opened in ages.

You can see a plasma cannon, a food ration, a Götti and a smoke nodule here.

>search
(the Locker)
You can't see inside, since the Locker is closed.

>x Locker
You see nothing special about the Locker.

>open Locker
It isn't something you can open.

* * *

>search
(the Locker)
You can't see inside, since the Locker is closed.

>take metal box
Taken.

>drop metal box
Dropped.

>open locker
It isn't something you can open.

* * *

>search
(the Locker)
You can't see inside, since the Locker is closed.

>open locker
You open the Locker, revealing a brushed metal box.

>open brushed metal box
You open the brushed metal box, revealing an Emergency Fire Kit.

>take
What do you want to take?

>take Emergency Fire Kit
Taken.

>s
Spaceship Exit
Insert description here.

* * *

>s
Spaceship Storage
Taking a quick look inside the storage room doesn't seem to reveal anything particularly interesting. There are only some random souvenirs from your previous intergalactic travels and your locker which you haven't opened in ages.

You can see a plasma cannon, a food ration, a Götti and a smoke nodule here.

>search locker
On the Locker is a brushed metal box.

>take metal box
Taken.

>open metal box
That's already open.

* * *

>s
Spaceship Storage
Taking a quick look inside the storage room doesn't seem to reveal anything particularly interesting. There are only some random souvenirs from your previous intergalactic travels and your locker which you haven't opened in ages.

You can see a plasma cannon, a food ration, a Götti and a smoke nodule here.

>search Spaceship Storage
You can't see any such thing.

>search
What do you want to search?

>search locker
You can't see inside, since the Locker is closed.

>open locker
You open the Locker, revealing a brushed metal box.

* * *

>open brushed metal box
You open the brushed metal box, revealing an Emergency Fire Kit.

>take emergency fire kit
Taken.

>s
Spaceship Exit
Insert description here.

>e
Spaceship Exit
Insert description here.

With the help of this Emergency Fire Kit I might be able to start a fire which should keep me warm for a while.

>w
Nothing to see here.

>n
Spaceship Storage
You take a quick look inside the storage room but there doesn't seem to be anything  particularly interesting in there. All you can see are some random souvenirs from other planets and your locker which you haven't opened in ages.

You can see a Plasma Cannon, a Food Ration, a Götti and a Smoke Nodule here.

>i
You are carrying:
  an Emergency Fire Kit

>drop all
(the Emergency Fire Kit)
Dropped.

>s
Spaceship Exit
Insert description here.

* * *

>s
Spaceship Storage
Taking a quick look inside the storage room doesn't seem to reveal anything particularly interesting. There are only some random souvenirs from your previous intergalactic travels and your locker which you haven't opened in ages.

You can see a plasma cannon, a food ration, a Götti and a smoke nodule here.

>take all
plasma cannon: Even though this is a highly experimental weapon it might prove useful at some point.

Taken.
food ration: Bringing food with you is never a bad idea.

Taken.
Götti: I'm really impressed by how adaptive this creature is. The cold doesn't seem to bother it at all and it even seems like it want's to come with me.

Taken.
smoke nodule: I totally forgot that I took one of these with me during my escape from the Gaisetto jungle.

Taken.

>put food ration in matter capacitor
You put the Food Ration into the matter capacitor.

>i
You are carrying:
  a Smoke Nodule
  a Götti
  a Plasma Cannon
  a wristwatch (being worn)
  a matter capacitor
    a Food Ration

>put all in matter capacitor
Smoke Nodule: Done.
Götti: Done.
Plasma Cannon: Done.

>drop all from matter capacitor
You can't use multiple objects with that verb.

>drop all
matter capacitor: Dropped.

>take matter capacitor
Taken.

* * *

>take all
plasma cannon: Even though this is a highly experimental weapon it might prove useful at some point.

Taken.
food ration: Bringing food with you is never a bad idea.

Taken.
Götti: I'm really impressed by how adaptive this creature is. The cold doesn't seem to bother it at all and it even seems like it want's to come with me.

Taken.
smoke nodule: I totally forgot that I took one of these with me during my escape from the Gaisetto jungle.

Taken.

>n
Spaceship Bridge
The place where all the magic happens. Well, it used to be at least - during the impact most of the important equpiment including the communication systems must have been fried and doesn't seem to work anymore.  There's only a single illuminated button that is flickering on the command panel. What could this mean? Might be worth checking out.

>x
What do you want to examine?

>command panel
You see nothing special about the command panel.

>search command panel
You can't see inside, since the command panel is closed.

>open command panel
You open the command panel, revealing a fried communicator, flickering buttons and a secret storage compartment.

>open secret storage compartment
You open the secret storage compartment, revealing an energy orb.

>take energy orb
This orb holds a huge amount of energy which could also be used to power all kinds of devices and possibly even weapons.

You're carrying too many things already.

>use food ration
That's not a verb I recognise.

>use energy orb
That's not a verb I recognise.

* * *

>s
Spaceship Storage
Taking a quick look inside the storage room doesn't seem to reveal anything particularly interesting. There are only some random souvenirs from your previous intergalactic travels and your locker which you haven't opened in ages.

You can see a plasma cannon, a food ration, a Götti and a smoke nodule here.

>take plasma cannon
Even though this is a highly experimental weapon it might prove useful at some point.

Taken.

>take food ration
Bringing food with you is never a bad idea.

Taken.