Mayday, Mayday - your sight is extremly limited to only a few meters, you have to land the space ship as soon as possible. Loss of signal to your surrounding satellites will mean plane crash. You make your way down through massive ash clouds with flying rocks everywhere. Luckily you are able to land safely on planet Geysiria. A planet where no life exists.  Volcanoes, lava rocks, big waves, geysirs and deserted landcsape is what you find here. In order to leave this planet you need to bring the volcanoes to a standstill or find another way to leave this unpleasant planet. Good luck.

Auf_der_Suche
An Interactive Fiction by Kevin Koch
Release 1 / Serial number 170612 / Inform 7 build 6M62 (I6/v6.33 lib 6/12N) SD

Landing Zone_Geysiria

>go east
beach

>go north
You can't go that way.

>go to the city
You can't see any such thing.

>go down
You can't go that way.

>go up
You can't go that way.

>go above
You can't see any such thing.

>fly above
That's not a verb I recognise.

>go up
You can't go that way.

>west
landing zone
 The landing zone is where you land.

>east
beach

>above
That's not a verb I recognise.

>up
You can't go that way.

>go
You'll have to say which compass direction to go in.

>clear
What do you want to clear?

>the story
You can't see any such thing.

>clear story
You can't see any such thing.

>back
That's not a verb I recognise.

>e
You can't go that way.

>w
landing zone
 The landing zone is where you land.

>e
beach

>d
You can't go that way.

>u
You can't go that way.

>examine
What do you want to examine?

>x
What do you want to examine?

* * *

>w
Huge cloud of ash, leave this zone as soon as possible. Risk of death, don't smother.

>e
Huge cloud of ash, leave this zone as soon as possible. Risk of death, don't smother.

>s
Huge cloud of ash, leave this zone as soon as possible. Risk of death, don't smother.

>n
Huge cloud of ash, leave this zone as soon as possible. Risk of death, don't smother.

* * *

>x
What do you want to examine?

>person
You can't see any such thing.

>x Axesto
What he's looking at?

I beg your pardon?

>x Doktor Gaschi
You can't see any such thing.

* * *

>x
What do you want to examine?

>x beach
You can't see any such thing.

>x true
You can't see any such thing.

>x false
You can't see any such thing.

* * *

>x Axesto
What he's looking at?

Axesto doesn't want to be examined.

>x Axesto
You can't see any such thing.

* * *

>x Doktor Gaschi
He farts all the time and is acting like a person with down syndrome.

* * *

>x landing zone
You can't see any such thing.