Your ship falls through thick layers of dark clouds. Red flashes illuminate your surroundings. The lights on your console warn you of the dangerously fast approaching energy level zero. As you finally break through the last cloud, you get a glimpse of what awaits you underneath. 
Black planes and sharp cliffs of a dark red shape the landscape. In the east you perceive a massive rock formation, in the west you see a thick blue stream cutting through the plane , illuminating big portions of it in the process. Somewhere to the south there seem to be some sort of industrial constructions, far in the north you believe to recognize cubic shapes that reveal a city. You don't have time to study the landscape much longer. All you concentration is desperately needed as you find a gap in the ghastly cliffs and bring down your ship. Heavy jolting, followed by a sudden blow signalize your landing. 
Your ship's on the ground, and you are too, barely. Welcome to Frizza.

Frizza
An Interactive Fiction by Tim
Release 1 / Serial number 170702 / Inform 7 build 6M62 (I6/v6.33 lib 6/12N) SD

Landing Zone
You step out of your ship onto a small square in the middle of nowhere. Your ship's dead and so is the computer. It seems like you ought to explore the environment. You remeber having seen civilization-like shapes to the south-west and to the north. To the east  there is a huge mountain, to the west there seems to be a Flux.

You can see a Discharged Spaceship (empty) here.

>e
Ascent
The mountains are composed of stone in various shades of red and reach far to the sky. In between the cliffs and sheers you see a narrow path winding up. There is no clue on where it might lead, but you could find out.

>u
You have the feeling of being watched. You wouldn't want to climb the cliffs if someone is around.

>x
(Dunia)
A lean but athletic figure, wrapped by several layers of what looks like tough leather. In a small gap of her hood you can see glinting eyes that reveal a sharp mind.

- You are painfully near to trespass holy ground, stranger. I would advise against it. Who are you, anyway? You don't look like a Techie. Tell me your name.

>call
That's not a verb I recognise.

>talk
That's not a verb I recognise.

* * *

>answer Duju
(to Someone)
- Well then, that's not a bad way to start. Thinking about it - an outsider might be what we need. I'll introduce you to someone, and that is not an invitation.

 With seemingly little effort she climbs down the cliffs to your level, before insistently inviting you to come with her.
 Both of you walk through the scraggy landscape, her leading the way with distinct commands. Slowly you approach an archlike structure, close to one branch of the Flux. As you get nearer you perceive a couple of bulky shapes, guarding the entrance to the structure. Some hundred metes in front of the entrance your companion turns to you. 

- Try not to look too provoking.

You know why while passing the guards: each and every one of them gazes at you. In consideration of the thick armour plates, the rather oversized guns and their radiating blue glow you refrain from making any quick motions.

Flux Gate
You can see a console, a weapon's rack (on which is a gun), Duju Operator 1 and Duju Operator 2 here.

Inside you find yourself in the midst of a small-sized hall, that doesn't appear to justify any of the expenditure you just encountered. In the back you spot an opening and a staircase, leading downwards. To the left there is a full board of controls and two figures unhastily operating them. You can't look around any more, as you are approached quickly by an impressive sized person, already bellowing a few direct words with a booming voice.

 - Dunia! Who is this? Explain yourself!

- A guest of sorts. He stumbled about the Ascent when I found him. I don't think he's a Techie, at least he has a slightly better manners and he keeps his voice down to a sensible level when talking. Besides, I thought about his use in regard to certain issues, due to his undujulike appearance.

Both eyeball you thoroughly for what seems to you like hours. Eventually, the massive Duju makes a quick motion towards Dunia, indicating her to follow him. He shoots a last glance at you.

- Don't let yourself be found sniffing around somewhere, it would not contribute to your wellbeing.

 They march off, disappearing into the opening at the end of the hall. You are not guarded, it seems like you could look around. Of course you could also do as you were told and wait.

>answer Techie
Whom do you want to answer that to?

* * *

>x
What do you want to examine?

>x Du'un
A massive build draped with heavy robes. In his left hand he carries an oblong staff, with a glowing ord at the end, that appears to be somewhere between shamanic fetish and technical apparatus. The blue eyes are attentive, especially about you.

>x Flux Gate
You can't see any such thing.

>e
Wasteland
A pitiful piece of land. Black sand, red rocks and some sickish looking plants. If you are not looking for something particular there is no need to linger.

>w
Flux Gate
A gate of some sort, guarded.

You can see Du'un and Dunia here.

>x
What do you want to examine?

* * *

>e
Wasteland
A pitiful piece of land. Black sand, red rocks and some sickish looking plants. If you are not looking for something particular there is no need to linger.

>w
Flux Gate
A gate of some sort, guarded.

You can see Keeper Du'un and Dunia here.

>x
What do you want to examine?

>x Duun
You can't see any such thing.

>x Du'un
A massive build draped with heavy robes. In his left hand he carries an oblong staff, with a glowing ord at the end, that appears to be somewhere between shamanic fetish and technical apparatus. The blue eyes are attentive, especially about you.

>x Dunia
A lean but athletic figure, wrapped by several layers of what looks like tough leather. In a small gap of her hood you can see glinting eyes that reveal a sharp mind.

* * *

>look around
You can't see any such thing.

>look
Flux Gate
On the weapon's rack is a gun.

You can also see Duju Operator 1 and Duju Operator 2 here.

>x
What do you want to examine?

>x Gate
You can't see any such thing.

>x Upper gate
You can't see any such thing.

>x Upper Gate_Frizza
You can't see any such thing.

>wait
You stand still where you were left. Time passes. However, that seems to be the only thing to change.

>wait
You pass the time looking closer at your surroundings, but you can't interpret all too much from the metallic alien structures. The architecture somewhat reminds you of the spiritual buildings on your home planet, as for the arching walls and the high ceiling. The only thing you hear is the distant, lamish flow of the Flux and the dull sounds of the two operators at the console.

>wait
Finally you see the two Duju returning from the opening. As they approach the big one actually looks amazed by your decent behaviour.

- It seems like you did as you were told. Maybe you don't have no ill intent after all. Indeed - that is exactly what we're going to find out, if you're willing. But you see, we don't want to force anything on you, you are free to leave. But if you are interested in helping us, we would be glad.

* * *

>x Upper Gate_Frizza
You can't see any such thing.

>x
What do you want to examine?

>x console
A huge oval table, full of ... nothing, actually. All you see is a reflective surface, into which the operators dunk their hands, emitting small waves. Where they touch the surface, you believe to see tiny, interlinked pulses of blue light, like a neural system, but you can't be sure. As you study the console, the two operators become aware of you, freezing in their motion and watching you suspiciously.

>x
What do you want to examine?

* * *

>x console
A huge oval table, full of ... nothing, actually. All you see is a reflective surface, into which the operators dunk their hands, emitting small waves. Where they touch the surface, you believe to see tiny, interlinked pulses of blue light, like a neural system, but you can't be sure. As you study the console, the two operators become aware of you, freezing in their motion and watching you suspiciously.

>take all
gun: Taken.

>talk
That's not a verb I recognise.

>talk to
That's not a verb I recognise.

>ask the Duju
Who do you mean, Duju Operator 1 or Duju Operator 2?

* * *

>x console
A huge oval table, full of ... nothing, actually. All you see is a reflective surface, into which the operators dunk their hands, emitting small waves. Where they touch the surface, you believe to see tiny, interlinked pulses of blue light, like a neural system, but you can't be sure.

As you study the console, the two operators become aware of you, freezing in their motion and watching you suspiciously.

>look
Flux Gate
You can see a console, a weapon's rack (on which is a gun), Duju Operator 1 and Duju Operator 2 here.

>take console
It's huge. Besides, you don't even dare touch it.

>take gun
Until now you were perceived as peaceful. Taking a foreign gun in the middle of a foreign building could change that impression. Think good before taking it.

>take gun
Taken.

>look
Flux Gate
You can see a console, a weapon's rack, Duju Operator 1 and Duju Operator 2 here.

>take console
It's huge. Besides, you don't even dare touch it.

I beg your pardon?

I beg your pardon?

* * *

>x console
A huge oval table, full of ... nothing, actually. All you see is a reflective surface, into which the operators dunk their hands, emitting small waves. Where they touch the surface, you believe to see tiny, interlinked pulses of blue light, like a neural system, but you can't be sure.

As you study the console, the two operators become aware of you, freezing in their motion and watching you suspiciously.

>x gun
An unfamiliar form of metal with a glowing core, you can barely identify it, except for the muzzle. Honestly, you wouldn't even know how to fire it.

>x operator
Who do you mean, Duju Operator 1 or Duju Operator 2?

>x operator 1
They seem very focussed. Their bodies pulse with light - something you haven't seen with the other types yet.

>talk
That's not a verb I recognise.

* * *

>talk to
That's not a verb I recognise.

>ask operator 1
What do you want to ask Duju Operator 1 for?

>ask operator 1 about information
There is no reply.

>x console
You see nothing special about the console.

As you continue to glance at the console, one of the operators pulls his hands out of it and stands up from his chair. You don't seem like making a soothing impression by standing there, maybe it would be wise to say something or disengage from the console.

* * *

>x console
A huge oval table, full of ... nothing, actually. All you see is a reflective surface, into which the operators dunk their hands, emitting small waves. Where they touch the surface, you believe to see tiny, interlinked pulses of blue light, like a neural system, but you can't be sure.

As you study the console, the two operators become aware of you, freezing in their motion and watching you suspiciously.

>x console
A huge oval table, full of ... nothing, actually. All you see is a reflective surface, into which the operators dunk their hands, emitting small waves. Where they touch the surface, you believe to see tiny, interlinked pulses of blue light, like a neural system, but you can't be sure.

As you continue to glance at the console, one of the operators pulls his hands out of it and stands up from his chair. Obviously you don't make a good impression by standing there, maybe it would be wise to say something or disengage from the console.

>ask Operator 1 about information
One of them directs his gaze towards you, before turning to the other as you fall silent. They seem to speak, though you don't understand anything. The sounds you hear are reverberant, bright clanging, like shaking a thin sheet of iron. Soon after, both of them stop their chatter and continue to operate the console, ignoring you.

* * *

>look
Flux Gate
You can see a console, a weapon's rack (on which is a gun), Duju Operator 1 and Duju Operator 2 here.

>take gun
Until now you were considered peaceful. Taking a foreign gun in the middle of a foreign building could change that impression. Think good before taking it.

* * *

>x
What do you want to examine?

>x console
A huge oval table, full of ... nothing, actually. All you see is a reflective surface, into which the operators dunk their hands, emitting small waves. Where they touch the surface, you believe to see tiny, interlinked pulses of blue light, like a neural system, but you can't be sure.

As you study the console, the two operators become aware of you, freezing in their motion and watching you suspiciously.

* * *

>x console
A huge oval table, full of ... nothing, actually. All you see is a reflective surface, into which the operators dunk their hands, emitting small waves. Where they touch the surface, you believe to see tiny, interlinked pulses of blue light, like a neural system, but you can't be sure.

As you continue to glance at the console, one of the operators pulls his hands out of it and stands up from his chair. Obviously you don't make a good impression by standing there, maybe it would be wise to say something or disengage from the console.

>x console
A huge oval table, full of ... nothing, actually. All you see is a reflective surface, into which the operators dunk their hands, emitting small waves. Where they touch the surface, you believe to see tiny, interlinked pulses of blue light, like a neural system, but you can't be sure.

* * *

>x
(Dunia)
A lean but athletic figure, wrapped by several layers of what looks like tough leather. In a small gap of her hood you can see glinting eyes that reveal a sharp mind.

- You are painfully near to trespass holy ground, stranger. I would advise against it. Who are you, anyway? You don't look like a Techie. Tell me your name.

>answer Axesto
(to Dunia)
What a strange name. It doesn't matter anyway - there's only one thing I need to know: are you on the side of the Techies or of the Duju?

>answer Duju
(to Dunia)
- Well then, that's not a bad way to start. Thinking about it - an outsider might be what we need. I'll introduce you to someone, and that is not an invitation.

 With seemingly little effort she climbs down the cliffs to your level, before insistently inviting you to come with her.
 Both of you walk through the scraggy landscape, her leading the way with distinct commands. Slowly you approach an archlike structure, close to one branch of the Flux. As you get nearer you perceive a couple of bulky shapes, guarding the entrance to the structure. Some hundred metes in front of the entrance your companion turns to you. 

- Try not to look too provoking.

You know why while passing the guards: each and every one of them gazes at you. In consideration of the thick armour plates, the rather oversized guns and their radiating blue glow you refrain from making any quick motions.

Flux Gate
You can see a console, a weapon's rack (on which is a gun), Duju Operator 1 and Duju Operator 2 here.

Inside you find yourself in the midst of a small-sized hall, that doesn't appear to justify any of the expenditure you just encountered. In the back you spot an opening and a staircase, leading downwards. To the left there is a full board of controls and two figures unhastily operating them. You can't look around any more, as you are approached quickly by an impressive sized person, already bellowing a few direct words with a booming voice.

 - Dunia! Who is this? Explain yourself!

- A guest of sorts. He stumbled about the Ascent when I found him. I don't think he's a Techie, at least he has a slightly better manners and he keeps his voice down to a sensible level when talking. Besides, I thought about his use in regard to certain issues, due to his undujulike appearance.

Both eyeball you thoroughly for what seems to you like hours. Eventually, the massive Duju makes a quick motion towards Dunia, indicating her to follow him. He shoots a last glance at you.

- Don't let yourself be found sniffing around somewhere, it would not contribute to your wellbeing.

 They march off, disappearing into the opening at the end of the hall. You are not guarded, it seems like you could look around. Of course you could also do as you were told and wait.

>wait
You stand still where you were left. Time passes. However, that seems to be the only thing to change.

* * *

>wait
You pass the time looking closer at your surroundings, but you can't interpret all too much from the metallic alien structures. The architecture somewhat reminds you of the spiritual buildings on your home planet, as for the arching walls and the high ceiling. The only thing you hear is the distant, lamish flow of the Flux and the dull sounds of the two operators at the console.

>ask Dunia about Cloak
You can't see any such thing.

>wait
Finally you see the two Duju returning from the opening. As they approach, the big one actually looks amazed by your decent behaviour.

- It seems like you did as you were told. Maybe you don't have no ill intent after all. Indeed - that is exactly what we're going to find out, if you're willing. But you see, we don't want to force anything on you, you are free to leave. But if you are interested in helping us, we would be glad.

He hands you something that distantly reminds you of a fishing net, only is this one almost ridiculously overengineered. You must have a rather puzzled look to your face, as Du'un starts to explain soon after. 

- That is a Flux Extractor, the Techies call them "Scoops". It is used to extract small portions of the Flux and isolate it for examination. If you want to help us out, showing us that you have no evil intent in the process, go and extract two samples of the Flux, one from the current before it passes through this gate, and one after it has done so. I am sure you will find the proper locations for this purpose yourself. When you are done or have any questions, return here, Dunia will be to your assistance.

You receive a Flux Extractor.

With that, Du'un goes off, quickly descending the stairs at the back of the hall. You are left with a vague task and Dunia, who doesn't look very pleased.

- To your assitance, eh? Well, better than climbing that awful piece of a mountain, I suppose.

>x console
A huge oval table, full of ... nothing, actually. All you see is a reflective surface, into which the operators dunk their hands, emitting small waves. Where they touch the surface, you believe to see tiny, interlinked pulses of blue light, like a neural system, but you can't be sure. 

As you study the console, the two operators become aware of you, freezing in their motion and watching you suspiciously.

Anyhow, you could examine the console further.

>x console
After taking a closer look, you make out that the energy of the Operators seems to be induced into the console. You start to see a pattern in the waves and currents of the reflective surface ... it reminds you of the great Flux currents ... 

As you continue to glance at the console, one of the operators pulls his hands out of it and stands up from his chair. Obviously you don't make a good impression by standing there, maybe it would be wise to say something or disengage from the console. Still, you could examine it further.

>x console
You can't make out anything new, the Operators are ridiculously shy.

>e
Wasteland
A pitiful piece of land. Black sand, red rocks and some sickish looking plants. If you are not looking for something particular there is no need to linger.

>n
Verge of the Bloo City
An averagely sized city extends in front of you. Its cityscape is dominated by an enormous building in the rear part, not resembling any architecture that you have ever seen. Halfway to it there seems to be some sort of city center. The city is surrounded by a foreign sort of fencing, with a gate not far form you.

>w
Flux beyond the Gate
Another current of the Flux. Even from the distance you feel the pure energy flooding your body. It appears to have a slightly different viscosity than the other Fluxes, maybe it has something to do with the Flux Gate arking above the Flux in the south.

You can see a Flux Current here.

>open
(the Flux Extractor)
It isn't something you can open.

>open Flux
(the Flux Extractor)
It isn't something you can open.

>open Flux Current
It isn't something you can open.

>take essence
You can't see any such thing.

>extract
(sample from the Flux Current)

* * *

>e
Ascent
The mountains are composed of stone in various shades of red and reach far to the sky. In between the cliffs and sheers you see a narrow path winding up. There is no clue on where it might lead, but you could find out.

I beg your pardon?

>u
You have the feeling of being watched. You wouldn't want to climb the cliffs if someone is around.

* * *

>x
(Dunia)
A lean but athletic figure, wrapped by several layers of what looks like tough leather. In a small gap of her hood you can see glinting eyes that reveal a sharp mind.

- You are painfully near to trespass holy ground, stranger. I would advise against it. Who are you, anyway? You don't look like a Techie. Tell me your name.

>x
(Dunia)
A lean but athletic figure, wrapped by several layers of what looks like tough leather. In a small gap of her hood you can see glinting eyes that reveal a sharp mind.

>Axesto
That's not a verb I recognise.

>answer Axesto
(to Dunia)
What a strange name. It doesn't matter anyway - there's only one thing I need to know: are you on the side of the Techies or of the Duju?

* * *

>wait
You stand still where you were left. Time passes. However, that seems to be the only thing to change.

>x console
A huge oval table, full of ... nothing, actually. All you see is a reflective surface, into which the operators dunk their hands, emitting small waves. Where they touch the surface, you believe to see tiny, interlinked pulses of blue light, like a neural system, but you can't be sure. 

As you study the console, the two operators become aware of you, freezing in their motion and watching you suspiciously.

Anyhow, you could examine the console further.

>wait
You pass the time looking closer at your surroundings, but you can't interpret all too much from the metallic alien structures. The architecture somewhat reminds you of the spiritual buildings on your home planet, as for the arching walls and the high ceiling. The only thing you hear is the distant, lamish flow of the Flux and the dull sounds of the two operators at the console.

>wait
Finally you see the two Duju returning from the opening. As they approach, the big one actually looks amazed by your decent behaviour.

- It seems like you did as you were told. Maybe you don't have no ill intent after all. Indeed - that is exactly what we're going to find out, if you're willing. But you see, we don't want to force anything on you, you are free to leave. But if you are interested in helping us, we would be glad.

He hands you something that distantly reminds you of a fishing net, only is this one almost ridiculously overengineered. You must have a rather puzzled look to your face, as Du'un starts to explain soon after. 

- That is a Flux Extractor, the Techies call them "Scoops". It is used to extract small portions of the Flux and isolate it for examination. If you want to help us out, showing us that you have no evil intent in the process, go and extract two samples of the Flux, one from the current before it passes through this gate, and one after it has done so. I am sure you will find the proper locations for this purpose yourself. When you are done or have any questions, return here, Dunia will be to your assistance.

You receive a Flux Extractor.

With that, Du'un goes off, quickly descending the stairs at the back of the hall. You are left with a vague task and Dunia, who doesn't look very pleased.

- To your assitance, eh? Well, better than climbing that awful piece of a mountain, I suppose.

>ask Dunia about Flux
- Yeah, our essence and all that shit. Don't mention it.

>ask Dunia about Kollock
- Our spiritual leader. Celebrated as god-king. "He is master, he is Flux".

Her tone seems to you tinged with a trace of sarcasm. She looks around, as if to see if nobody is within earshot.

- Though some appreciate their freedom more than others.

>ask Dunia about Du'un
- My father and the Keeper of the Flux, if you didn't notice. He taught me to keep an open mind for things, even if his own mental flexibility starts to crumble at the moment.

>ask Dunia about Techies
- They were settler's, originally. Sadly they chose to defile the Flux with their robots and devices, hence their nickname. We are not at good terms at the moment, our "Leader" Kollock even is bitterly hostile towards them, as he sees them as heretics.

>Ask Dunia about Flux Extractor
She giggles a bit.

- It is simple, you will see when you get to the Flux. Just dip it in.

She shows a devilish grin. Oh, but there's something I can help you with.

Suddenly Dunia grasps a corner of her leathery clothing and, with one swoosh, unwraps it from her body. Underneath, a sinewy, bluish body comes to appearance.

- Here, take this, it will prevent the Flux from disintegrating you all too fast.

The devilish grin emerges again.

- And stop staring.

You receive a Sinkan Cloak.