On the Lookout
An Interactive Fiction by Franziska, Daniel, Kevin, Tim, Tobias
Release 1 / Serial number 170630 / Inform 7 build 6M62 (I6/v6.33 lib 6/12N) SD

Spaceship Bridge
The place where all the magic happens. Well, it used to be at least - during the impact most of the important equpiment including the communication systems must have been fried and doesn't seem to work anymore.  There's only a single flickering light inside the command panel. What could this mean? I should probably open the command panel and take a look. I could also go south and check the storage of the spaceship first.

>x me
As good-looking as ever.

>my name?
That's not a verb I recognise.

>what is my name?
That's not a verb I recognise.

>s
You don't want to go there.

>e
The Wide Desert
 The Desert of Sitis gives you the chance to gain orientation. When you look north you see a big brown golden palace. In the east you recognize an old dark House. Description missed! When you look south you recognize a lot of small white houses. It seems like people are living there .

* * *

On the Lookout
An Interactive Fiction by Franziska, Daniel, Kevin, Tim, Tobias
Release 1 / Serial number 170630 / Inform 7 build 6M62 (I6/v6.33 lib 6/12N) SD

Spaceship Bridge
The place where all the magic happens. Well, it used to be at least - during the impact most of the important equpiment including the communication systems must have been fried and doesn't seem to work anymore.  There's only a single flickering light inside the command panel. What could this mean? I should probably open the command panel and take a look. I could also go south and check the storage of the spaceship first.

>s
Spaceship Storage
Taking a quick look inside the storage room doesn't seem to reveal anything particularly interesting. There are only some random souvenirs from your previous intergalactic travels and your locker which you haven't opened in ages.  It also looks like the airlock in the south doesn't seem to function anymore so perhaps I should go check that out as well?

>n
You got caught in a meteor shower and while trying your best to manouver your spaceship through it  your engine still took a hit. You then had to crash-land on Kaldríss - one of the most cold planets in this solar system.  Since only a few explorers made their to this planet there's not a whole lot of information available about this icy place. You are pretty much on your own now. The spaceship also won't take off before it hasn't been properly repaired. But first things first. Without any kind of heat you won't survive this bleakness for long. You tame a look at the command panel in hopes of finding something of use but it doesn't look very good. There's only a single green button on the command panel. What could this mean? Might be worth checking out. I could also go south and check storage.

>s
Spaceship Storage
Taking a quick look inside the storage room doesn't seem to reveal anything particularly interesting. There are only some random souvenirs from your previous intergalactic travels and your locker which you haven't opened in ages.  It also looks like the airlock in the south doesn't seem to function anymore so perhaps I should go check that out as well?

>n
Spaceship Bridge
The place where all the magic happens. Well, it used to be at least - during the impact most of the important equpiment including the communication systems must have been fried and doesn't seem to work anymore.  There's only a single illuminated button that is flickering on the command panel. What could this mean? Might be worth checking out. I could also go south and check the storage of the spaceship.

>s
Spaceship Storage
Taking a quick look inside the storage room doesn't seem to reveal anything particularly interesting. There are only some random souvenirs from your previous intergalactic travels and your locker which you haven't opened in ages.  It also looks like the airlock in the south doesn't seem to function anymore so perhaps I should go check that out as well?

* * *

>n
You don't want to go there.

* * *

On the Lookout
An Interactive Fiction by Franziska, Daniel, Kevin, Tim, Tobias
Release 1 / Serial number 170630 / Inform 7 build 6M62 (I6/v6.33 lib 6/12N) SD

Spaceship Bridge
The place where all the magic happens. Well, it used to be at least - during the impact most of the important equpiment including the communication systems must have been fried and doesn't seem to work anymore.  There's only a single flickering light inside the command panel. What could this mean? I should probably open the command panel and take a look. I could also go south and check the storage of the spaceship first.

>x command panel
You see nothing special about the command panel.

I could open this baby up and take a peak inside.

>take encryption key
You can't see any such thing.

>look around
You can't see any such thing.

>x command panel
You see nothing special about the command panel.

* * *

>x command panel
You see nothing special about the command panel.

I could open this baby up and take a peak inside.

>open command panel
You open the command panel, revealing a protector glove, a fried communicator, a secret storage and a green button.

>open secret storage compartment
I only understood you as far as wanting to open the secret storage.

>open secret storage compartment
That's already open.

* * *

>open secret storage compartment
I only understood you as far as wanting to open the secret storage.

>push green button
It is fixed in place.

>push green button
It is fixed in place.

>x secret storage compartment
I only understood you as far as wanting to examine the secret storage.

>take all
fried communicator: Taken.

>drop all
fried communicator: Dropped.

* * *

>open command panel
You open the command panel, revealing a protector glove, a fried communicator, a secret storage and a green button.

>open secret storage
You open the secret storage, revealing an encryption key and an energy orb.

* * *

>open command panel
You open the command panel, revealing a protector glove, a fried communicator, a secret storage and a green button.

>x button
The green button is currently switched off.

>turn button on
Beep Boop! Secret storage status: OPEN.

>open secret storage
You open the secret storage, revealing an energy orb and an encryption key.

>take all
protector glove: Taken.
energy orb: I totally forgot that I've put this here. This orb holds a huge amount of energy which could be used to power all kinds of devices and possibly even weapons.

I really shouldn't be touching the energy orb without something that protects my hands.
encryption key: Taken.

>x key
You see nothing special about the encryption key.

>x weight key
You can't see any such thing.

>insert key into suit capacitor
You put the encryption key into Suit capacitor.

Suit capacitor splits and breaks under the weight! You discard its ruined remains, looking miserably down at the encryption key on the floor.

* * *

>x weight key
You can't see any such thing.

>insert energy orb into suit capacitor
Do I really wanna do this? Chances of me dying are quite high. On the other hand, I will probably die anyway if I don't try.

You fear touching the energy orb.

>s
Spaceship Storage
Taking a quick look inside the storage room doesn't seem to reveal anything particularly interesting. There are only some random souvenirs from your previous intergalactic travels and your locker which you haven't opened in ages.  It also looks like the airlock in the south doesn't seem to function anymore so perhaps I should go check that out as well?

>s
Spaceship Exit
The airlock also seems to be affected by the crash and the temperatures inside the spaceship are nearing dangerous levels. I could leave the spaceship right now by going east but I if I don't have something to protect me from the cold I will probably die.

>e
You can't leave the spaceship just yet. You need to find something to keep you warm before you venture off!

>x suit capacitor
This capacitor only holds certain types of energy sources which usually maintain the suit's functionality such as protecting the wearer from extreme temperatures. Inserting anything other than pure energy e.g. matter of all sorts will most likely destroy the capacitor and might even result in a horrible death.  Caution is advised here!

>insert energy orb into suit capacitor
You can't see any such thing.

>yes
That was a rhetorical question.

>ok
That's not a verb I recognise.

* * *

>x key
You see nothing special about the encryption key.

>take energy orb
I totally forgot that I've put this here. This orb holds a huge amount of energy which could be used to power all kinds of devices and possibly even weapons.

I really shouldn't be touching the energy orb without something that protects my hands.

>put on glove
You put on the protector glove.

>take energy orb
I totally forgot that I've put this here. This orb holds a huge amount of energy which could be used to power all kinds of devices and possibly even weapons.

This could really work!

Taken.

>touch energy orb
You feel nothing unexpected.

>i
You are carrying:
  an energy orb
  an encryption key
  a protector glove (being worn)
  suit capacitor (being worn)

>s
Spaceship Storage
Taking a quick look inside the storage room doesn't seem to reveal anything particularly interesting. There are only some random souvenirs from your previous intergalactic travels and your locker which you haven't opened in ages.  It also looks like the airlock in the south doesn't seem to function anymore so perhaps I should go check that out as well?

>open locker
It seems to be locked.

>unlock locker with encryption key
You unlock the locker.

>open locker
You open the locker, revealing an emergency torch.

>take protector glove
You already have that.

>wear protector glove
You're already wearing that!

>n
You got caught in a meteor shower and while trying your best to manouver your spaceship through it  your engine still took a hit. You then had to crash-land on Kaldríss - one of the most cold planets in this solar system.  Since only a few explorers made their to this planet there's not a whole lot of information available about this icy place. You are pretty much on your own now. The spaceship also won't take off before it hasn't been properly repaired. But first things first. Without any kind of heat you won't survive this bleakness for long. You tame a look at the command panel in hopes of finding something of use but it doesn't look very good. There's only a single green button on the command panel. What could this mean? I might also wanna  take a look at the spaceship exit that lies straight ahead since it seems to be busted, too.

>s
Spaceship Storage
Taking a quick look inside the storage room doesn't seem to reveal anything particularly interesting. There are only some random souvenirs from your previous intergalactic travels and your locker which you haven't opened in ages.  It also looks like the airlock in the south doesn't seem to function anymore so perhaps I should go check that out as well?

>n
Spaceship Bridge
The place where all the magic happens. Well, it used to be at least - during the impact most of the important equpiment including the communication systems must have been fried and doesn't seem to work anymore.  There's only a single flickering light inside the command panel. What could this mean? I should probably open the command panel and take a look. I could also go south and check the storage of the spaceship first.

>open command panel
That's already open.

>x command panel
In the command panel are a fried communicator, a secret storage and a green button.

I could open this baby up and take a peak inside.

>push button
Boop Beep! Secret storage status: CLOSED.

>push button
Beep Boop! Secret storage status: OPEN.

>x secret storage
The secret storage is empty.

>take energy orb
I totally forgot that I've put this here. This orb holds a huge amount of energy which could be used to power all kinds of devices and possibly even weapons.

You already have that.

>insert energy orb in suit capacitor
Do I really wanna do this? Chances of me dying are quite high. On the other hand, I will probably die anyway if I don't try.

You put the energy orb into suit capacitor.

>drop glove
(first taking the protector glove off)
Dropped.

>take energy orb out of suit capacitor
I only understood you as far as wanting to take the energy orb.

>remove energy orb from suit capacitor
I really shouldn't be touching the energy orb without something that protects my hands.

* * *

>insert energy orb in suit capacitor
Do I really wanna do this? Chances of me dying are quite high. On the other hand, I will probably die anyway if I don't try.

You put the energy orb into suit capacitor.

>s
Spaceship Storage
Taking a quick look inside the storage room doesn't seem to reveal anything particularly interesting. There are only some random souvenirs from your previous intergalactic travels and your locker which you haven't opened in ages.  It also looks like the airlock in the south doesn't seem to function anymore so perhaps I should go check that out as well?

>e
You don't want to go there.

>i
You are carrying:
  an encryption key
  a protector glove (being worn)
  suit capacitor (being worn)
    an energy orb

>e
You don't want to go there.

* * *

>open command panel
You open the command panel, revealing a protector glove, a fried communicator, a secret storage and a green button.

>put on glove
(first taking the protector glove)
You put on the protector glove.

>push button
Beep Boop! Secret storage status: OPEN.

>x button
The green button is currently switched on.

>x secret storage
There is a reason this storage compartment is well hidden inside the command panel. Whatever is in there must be of great importance for this spaceship.

>x glove
This protector glove is made out of a special  rubber compound that temporarily absorbs any kind of energy thus protecting its wearer.

>x secret storage
There is a reason this storage compartment is well hidden inside the command panel. Whatever is in there must be of great importance for this spaceship.

>open secret storage
You open the secret storage, revealing an energy orb and an encryption key.

>take all
energy orb: I totally forgot that I've put this here. This orb holds a huge amount of energy which could be used to power all kinds of devices and possibly even weapons.

This could really work!

Taken.
encryption key: Taken.

>insert energy orb into suit capacitor
Do I really wanna do this? Chances of me dying are quite high. On the other hand, I will probably die anyway if I don't try.

You put the energy orb into suit capacitor.

>s
Spaceship Storage
Taking a quick look inside the storage room doesn't seem to reveal anything particularly interesting. There are only some random souvenirs from your previous intergalactic travels and your locker which you haven't opened in ages.  It also looks like the airlock in the south doesn't seem to function anymore so perhaps I should go check that out as well?

* * *

>s
Spaceship Exit
The airlock also seems to be affected by the crash and the temperatures inside the spaceship are nearing dangerous levels. I could leave the spaceship right now by going east but I if I don't have something to protect me from the cold I will probably die.

>e
Crash Zone
The surface of Kaldríss consists of spiky ice formations as far as the eye can see . No wonder nobody in his right mind would try to land here willingly. There doesn't seem to be anything of interest wherever you look. After taking a closer look you suddenly notice some sort of structure north of your position. If you hurry up you should be able to make it there before you freeze.

>n
Hunting Grounds
Turns out this used to be an explorer camp and you instantly feel a little less lonely and also more safe. Seems like a good place to stay for a while and trying not to freeze to death. But where did those explorers go and why did they leave pretty much everything behind? Further investigations of this place also reveal something resembling a cave entrance that lies underneath the camp.

You can see a stone plate here.

>shove stone plate aside
I didn't understand that sentence.

>x stone plate
You see nothing special about the stone plate.

This stone plate looks really heave but if I manage to shove it aside just a little bit I should be able to get past it.

>shove stone plate aside
I didn't understand that sentence.

>shove aside stone plate
You managed to shove the stone plate ot ouf the way and you are able to make your way down this really dark and tight cave. Let's just hope nothing bad happens.

>go down
You are finally able to enter the cave but you should still proceed with caution since you never know what's waiting inside.

Upon trying to make your way into the small cave entrance you slipped and went all the way down. Apart from a few scratches here and there you seem to be okay even though your head hurts quite a lot. You can barely see from where you landed but you see light a little further ahead and decide to go there. It's getting easier to see with every step you take and suddenly you hear noises. It sounds like someone is .. talking? Do humans live down here? Maybe it's one of the explorers from the camp above you. This would certainly explain where they went. On the other hand it could also be something entierly else so I should still be really careful when wandering around.

>look around
You can't see any such thing.

>look
Yundar's Cave
This is one of many caves which the Yetíss have built under the surface of Kaldríss. This one seems to belong to a young female Yetíss called Yundar.  It also connects to another cave if you go further in the east.

Young female Yetíss. Looks chummy but at the same time terrifying to some extent.

You can also see a stone plate and Yundar's Picking Tools here.

* * *

On the Lookout
An Interactive Fiction by Franziska, Daniel, Kevin, Tim, Tobias
Release 1 / Serial number 170630 / Inform 7 build 6M62 (I6/v6.33 lib 6/12N) SD

Spaceship Bridge
The place where all the magic happens. Well, it used to be at least - during the impact most of the important equpiment including the communication systems must have been fried and doesn't seem to work anymore.  There's only a single flickering light inside the command panel. What could this mean? I should probably open the command panel and take a look. I could also go south and check the storage of the spaceship first.

>open command panel
You open the command panel, revealing a protector glove, a fried communicator, a secret storage and a green button.

* * *

>open secret storage
You open the secret storage, revealing an encryption key and an energy orb.

>push button
Nothing obvious happens.

>push green button
Nothing obvious happens.

>close secret storage
That's already closed.

>open secret storage
That's already open.

>push green button
Nothing obvious happens.

* * *

>open command panel
You open the command panel, revealing a protector glove, a fried communicator, a secret storage and a green button.

>push green button
You can't see any such thing.

>push button
You can't see any such thing.

>open secret storage
You can't see any such thing.

>push button
You can't see any such thing.

>push button
You can't see any such thing.