On the Lookout
An Interactive Fiction by Franziska, Daniel, Kevin, Tim, Tobias
Release 1 / Serial number 170623 / Inform 7 build 6M62 (I6/v6.33 lib 6/12N) SD

Your arrival point. The Flat Rock
 You arrive on a planet called Sitis. You think the landing went great but as you leave your spaceship, you realise that two of your three water container broke down. Without minimum one new watertank you can not continue your journey. Far away in the east you recognise some kind of different rooftops. Maybe someones living there who could help you?

>x me
As good-looking as ever.

* * *

On the Lookout
An Interactive Fiction by Franziska, Daniel, Kevin, Tim, Tobias
Release 1 / Serial number 170623 / Inform 7 build 6M62 (I6/v6.33 lib 6/12N) SD

Your arrival point. The Flat Rock
 You arrive on a planet called Sitis. You think the landing went great but as you leave your spaceship, you realise that two of your three water container broke down. Without minimum one new watertank you can not continue your journey. Far away in the east you recognise some kind of different rooftops. Maybe someones living there who could help you?

>s
Spaceship Storage
Taking a quick look inside the storage room doesn't seem to reveal anything particularly interesting. There are only some random souvenirs from your previous intergalactic travels and your locker which you haven't opened in ages.  It also looks like the airlock in the south doesn't seem to function anymore so perhaps I should go check that out as well?

* * *

On the Lookout
An Interactive Fiction by Franziska, Daniel, Kevin, Tim, Tobias
Release 1 / Serial number 170623 / Inform 7 build 6M62 (I6/v6.33 lib 6/12N) SD

Your arrival point. The Flat Rock
 You arrive on a planet called Sitis. You think the landing went great but as you leave your spaceship, you realise that two of your three water container broke down. Without minimum one new watertank you can not continue your journey. Far away in the east you recognise some kind of different rooftops. Maybe someones living there who could help you?

>x command panel
You see nothing special about the command panel.

>take encryption key
You can't see any such thing.

* * *

>x command panel
You see nothing special about the command panel.

>open command panel
You open the command panel, revealing a secret storage, a fried communicator and a green button.

>open secret storage compartment
I only understood you as far as wanting to open the secret storage.

* * *

>open command panel
You open the command panel, revealing a secret storage, a fried communicator and a green button.

>open secret storage
You open the secret storage, revealing an encryption key and an energy orb.

* * *

On the Lookout
An Interactive Fiction by Franziska, Daniel, Kevin, Tim, Tobias
Release 1 / Serial number 170623 / Inform 7 build 6M62 (I6/v6.33 lib 6/12N) SD

Your arrival point. The Flat Rock
 You arrive on a planet called Sitis. You think the landing went great but as you leave your spaceship, you realise that two of your three water container broke down. Without minimum one new watertank you can not continue your journey. Far away in the east you recognise some kind of different rooftops. Maybe someones living there who could help you?

>open command panel
You open the command panel, revealing a secret storage, a fried communicator and a green button.

>push green button
You can't see any such thing.

* * *

>open command panel
You open the command panel, revealing a secret storage, a fried communicator and a green button.

>x fried communicator
You see nothing special about the fried communicator.

Yep, totally busted!

>open secret storage
It seems to be locked.

>push green button
Beep Boop! Secret storage status: OPEN.

>open secret storage
You open the secret storage, revealing an encryption key and an energy orb.

>take energy orb
I totally forgot that I've put this here. This orb holds a huge amount of energy which could be used to power all kinds of devices and possibly even weapons.

Taken.

>put energy orb into suit capacitor
You put the energy orb into the suit capacitor.

>s
Spaceship Storage
Taking a quick look inside the storage room doesn't seem to reveal anything particularly interesting. There are only some random souvenirs from your previous intergalactic travels and your locker which you haven't opened in ages.  It also looks like the airlock in the south doesn't seem to function anymore so perhaps I should go check that out as well?

* * *

>s
Spaceship Exit
The airlock also seems to be affected by the crash and the temperatures inside the spaceship are nearing dangerous levels. I could leave the spaceship right now by going east but I if I don't have something to protect me from the cold I will probably die.

>e
Crash Zone
The surface of Kaldríss consists of spiky ice formations as far as the eye can see . No wonder nobody in his right mind would try to land here willingly. A little further in the north you can vaguely see some sort of structure. You should be able to make it in time.

>n
Hunting Grounds
Turns out this used to be an explorer camp and you instantly feel a little less lonely and also more safe. Seems like a good place to stay for a while and trying not to freeze to death. But where did those explorers go and why did they leave pretty much everything behind? Further investigations of this place also reveal something that looks like a cave entrance underneath that lies underneath the camp.

>go down
Upon trying to make your way into the small cave entrance you slipped and went way further than you initally planned. Apart from a few scratches here and there you seem to be okay even though your head hurts quite a lot. You look around and try to understand where the hell you are when you suddenly see something that resembles a .. bear? It looks more humanoid though .. is it .. is this a .. Yeti?

>look around
You can't see any such thing.

>x
What do you want to examine?

>e
You see nothing unexpected in that direction.

>w
You don't want to go there.

>n
You don't want to go there.

>s
You don't want to go there.

>s
You don't want to go there.

>go west
You don't want to go there.

>e
Yarwol's Cave
This cave is where Yarwol, the oldest Yetíss, resides.

The oldest Yetíss in this cave system. Also very wise since he's been living on this planet for over 200 years.

You can also see Yarwol's Keystone here.

>take all
Yarwol's Keystone: Taken.

>s
Main Cave
Insert description here.

>e
A door magically opens and  eventually you are able to enter the secret cave in the east. Gaining the Yetíss trust wasn't easy but in the end you managed to do it and now it's finally time to find a way off this planet!

>go up
Blakkríss Temple Entrance
Insert description here.

It's dangerous to go alone!

>w
Great Hall
Insert description here.

>w
Spectral Bridge
Insert description here.

>w
Bifröst Portal Chamber
Insert description here.

I beg your pardon?

>end
That's not a verb I recognise.

* * *

On the Lookout
An Interactive Fiction by Franziska, Daniel, Kevin, Tim, Tobias
Release 1 / Serial number 170623 / Inform 7 build 6M62 (I6/v6.33 lib 6/12N) SD

Your arrival point. The Flat Rock
 You arrive on a planet called Sitis. You think the landing went great but as you leave your spaceship, you realise that two of your three water container broke down. Without minimum one new watertank you can not continue your journey. Far away in the east you recognise some kind of different rooftops. Maybe someones living there who could help you?

>Helper
---
 This is the help section, you will get a list of essential commands that you can use in the game.

look - shows you the room you are currently in
 e(x)amine - get information about a thing or a person
 take - take something

(e)ast - go east
 (w)est - go west
 (s)outh - go south
 (n)orth - go north

Frizza
 ask someone about something - the typical way to begin a dialogue, the topics you can ask about are printed bold in the text beforehand
 answer something (to someone) - the typical way to respond to questions, the topics you can answer are printed bold in the text beforehand
 wait - wait some time, some situations may require this
 wear (something) - put clothing on
 take off (something )- take off clothing

Kaldríss
 open/close something
 unlock/lock something
 insert something into something
 remove something from something
 shove something aside - some situations with blocked paths may require this
 put back something into place - WOZU?

End of help section
---

>Helper
---
 This is the help section, you will get a list of essential commands that you can use in the game.

look - shows you the room you are currently in
 e(x)amine - get information about a thing or a person
 take - take something

(e)ast - go east
 (w)est - go west
 (s)outh - go south
 (n)orth - go north

Frizza
 ask someone about something - the typical way to begin a dialogue, the topics you can ask about are printed bold in the text beforehand
 answer something (to someone) - the typical way to respond to questions, the topics you can answer are printed bold in the text beforehand
 wait - wait some time, some situations may require this
 wear (something) - put clothing on
 take off (something )- take off clothing

Kaldríss
 open/close something
 unlock/lock something
 insert something into something
 remove something from something
 shove something aside - some situations with blocked paths may require this
 put back something into place - WOZU?

End of help section
---

>e
The Wide Desert
 You've reached the Desert of Sitis. It gives you two things: First, an impression of what whole Sitis looks like - sandy, dry, with some deep stone canyons and huge rocks afar. But although this planet does not seem to be a place to life, the Desert also gives you the chance to discern that you are not alone. There IS life! When you look north, directly in front of you is a long corrugated iron bridge, guiding over one of those ravines. You can not access the bridge, it is blocked with a barbed wire fence, but straight ahead, at the end you see a majestic sandstone palace. In the bridge's middel, a wooden ladder leads to an enormous square block in the east. Likewise it is built out of stone and gives a somber impression. If you look east from the point you are standing at right now you realise that the canyon When you look south you recognize a lot of small white houses. It seems like people are living there .

>e
You don't want to go there.

>e
You don't want to go there.

>s
The Rampart of Sicuum

>s
The Agora of Sicuum

>e
Your Shelter
You can see Anaidis and Carissimi here.

>n
A secret Passage

>n
The Rock Mine
You can see Ilithios here.

>e
There is no way to advance in this direction.

>e
There is no way to advance in this direction.

* * *

On the Lookout
An Interactive Fiction by Franziska, Daniel, Kevin, Tim, Tobias
Release 1 / Serial number 170623 / Inform 7 build 6M62 (I6/v6.33 lib 6/12N) SD

Your arrival point. The Flat Rock
 You arrive on a planet called Sitis. You think the landing went great but as you leave your spaceship, you realise that two of your three water container broke down. Without minimum one new watertank you can not continue your journey. Far away in the east you recognise some kind of different rooftops. Maybe someones living there who could help you?

>e
The Wide Desert
 You've reached the Desert of Sitis. It gives you two things: First, an impression of what whole Sitis looks like - sandy, dry, with some deep stone canyons and huge rocks afar. But although this planet does not seem to be a place to life, the Desert also gives you the chance to discern that you are not alone. There IS life! When you look north, directly in front of you is a long corrugated iron bridge, guiding over one of those ravines. You can not access the bridge, it is blocked with a barbed wire fence, but straight ahead, at the end you see a majestic sandstone palace. In the bridge's middel, a wooden ladder leads to an enormous square block in the east. Likewise it is built out of stone and gives a somber impression. If you look east from the point you are standing at right now you see the kind of a rock mine. In the south you recognise a lot of small white houses surrounded by a rampart. It seems like people are living here .

>s
The Rampart around Sicuum
You can see a wooden gate here.

>open
(the backpack)
It isn't something you can open.

>open gate
You can't see any such thing.

>i
You are carrying:
  a backpack (being worn)

>ex
That's not a verb I recognise.

>x
(the backpack)
The backpack is empty.

>x gate
You can't see any such thing.

>x wooden gate
I only understood you as far as wanting to examine the wooden gate.

>open wooden gate
I only understood you as far as wanting to open the wooden gate.

* * *

>s
The Rampart around Sicuum
You can see a wooden gate here.

>open wooden gate
I only understood you as far as wanting to open the wooden gate.

>open gate
You can't see any such thing.

>examine wooden gate
I only understood you as far as wanting to examine the wooden gate.

>examine wooden gate_Sitis
You can see a high wooden gate here. It seems to be closed. Let's try to open it .

>open wooden gate_Sitis
Someone is yelling at you . "Who are you? And what do you want?"

>answer axesto
(to the Person behind the door_Sitis)
I am Axesto, an alien of the planet Fidatis. I landed here because I am travelling through the whole galaxy to discover the life on other plantes. During the landing here two of my water containers broke down. That's why I need you to ask for water. Can you give me a bit, please? 

First there's silence. Then the gate squeaks. It opens slowly.

>s
The Agora of Sicuum
 Beschreibung der Menschen .

You can see Anaidis here.

* * *

>s
The Rampart around Sicuum
You can see a wooden gate here.

>examine wooden gate
I only understood you as far as wanting to examine the Wooden Gate.

>examine wooden gate_Sitis
It seems to be closed. Let's try to open it .

* * *

>s
The Rampart around Sicuum
You can see a wooden gate here.

>examine Wooden Gate
It seems to be closed. Let's try to open it .